//MAP CONVERTED BY dmm2tgm.py THIS HEADER COMMENT PREVENTS RECONVERSION, DO NOT REMOVE
"a" = (
/turf/template_noop,
/area/template_noop)
"b" = (
/turf/closed/wall/mineral/titanium,
/area/shuttle/arrival)
"c" = (
/obj/machinery/door/airlock/titanium{
	name = "Arrivals Shuttle Airlock"
	},
/obj/structure/fans/tiny,
/turf/open/floor/mineral/titanium/tiled/blue,
/area/shuttle/arrival)
"d" = (
/obj/effect/spawner/structure/window/shuttle,
/turf/open/floor/plating,
/area/shuttle/arrival)
"e" = (
/obj/structure/closet/firecloset,
/turf/open/floor/mineral/titanium/tiled/white,
/area/shuttle/arrival)
"j" = (
/obj/structure/chair/comfy/shuttle{
	dir = 8
	},
/turf/open/floor/mineral/titanium/tiled/white,
/area/shuttle/arrival)
"k" = (
/obj/machinery/light{
	dir = 1
	},
/obj/structure/chair/comfy/shuttle{
	dir = 8
	},
/obj/structure/sign/nanotrasen{
	pixel_y = 32
	},
/turf/open/floor/mineral/titanium/tiled/white,
/area/shuttle/arrival)
"m" = (
/obj/structure/shuttle/engine/heater{
	dir = 4
	},
/obj/structure/window/reinforced{
	dir = 8
	},
/turf/open/floor/plating/airless,
/area/shuttle/arrival)
"n" = (
/obj/structure/shuttle/engine/propulsion/burst/right{
	dir = 4
	},
/turf/open/floor/plating/airless,
/area/shuttle/arrival)
"o" = (
/obj/machinery/requests_console{
	department = "Arrival shuttle";
	name = "Arrivals Shuttle console";
	pixel_y = 30
	},
/obj/structure/closet/wardrobe/black,
/turf/open/floor/mineral/titanium/tiled/white,
/area/shuttle/arrival)
"p" = (
/obj/structure/chair/comfy/shuttle,
/turf/open/floor/mineral/titanium/tiled/blue,
/area/shuttle/arrival)
"q" = (
/obj/structure/chair/comfy/shuttle,
/obj/machinery/light/small{
	dir = 4
	},
/turf/open/floor/mineral/titanium/tiled/blue,
/area/shuttle/arrival)
"s" = (
/obj/structure/shuttle/engine/propulsion{
	dir = 4
	},
/turf/open/floor/plating/airless,
/area/shuttle/arrival)
"t" = (
/obj/machinery/door/airlock/titanium{
	name = "Arrivals Shuttle Airlock"
	},
/turf/open/floor/mineral/titanium/tiled/white,
/area/shuttle/arrival)
"u" = (
/obj/structure/shuttle/engine/propulsion{
	dir = 4
	},
/obj/docking_port/mobile/arrivals,
/turf/open/floor/plating/airless,
/area/shuttle/arrival)
"v" = (
/obj/structure/chair/comfy/shuttle{
	dir = 1
	},
/turf/open/floor/mineral/titanium/tiled/blue,
/area/shuttle/arrival)
"w" = (
/obj/structure/chair/comfy/shuttle{
	dir = 1
	},
/obj/machinery/light/small{
	dir = 4
	},
/turf/open/floor/mineral/titanium/tiled/blue,
/area/shuttle/arrival)
"x" = (
/obj/structure/closet/emcloset,
/turf/open/floor/mineral/titanium/tiled/white,
/area/shuttle/arrival)
"y" = (
/obj/machinery/light,
/obj/structure/chair/comfy/shuttle{
	dir = 8
	},
/obj/structure/sign/nanotrasen{
	pixel_y = -32
	},
/turf/open/floor/mineral/titanium/tiled/white,
/area/shuttle/arrival)
"z" = (
/turf/open/floor/mineral/titanium/tiled/blue,
/area/shuttle/arrival)
"A" = (
/obj/structure/shuttle/engine/propulsion/burst/left{
	dir = 4
	},
/turf/open/floor/plating/airless,
/area/shuttle/arrival)
"B" = (
/obj/machinery/porta_turret/centcom_shuttle,
/turf/closed/wall/mineral/titanium,
/area/shuttle/arrival)
"H" = (
/obj/structure/closet/wardrobe/red,
/turf/open/floor/mineral/titanium/tiled/white,
/area/shuttle/arrival)
"I" = (
/obj/structure/table,
/obj/item/crowbar{
	pixel_x = -2;
	pixel_y = 6
	},
/obj/item/flashlight{
	pixel_x = 4;
	pixel_y = 2
	},
/turf/open/floor/mineral/titanium/tiled/white,
/area/shuttle/arrival)
"L" = (
/obj/structure/closet/wardrobe/grey,
/turf/open/floor/mineral/titanium/tiled/white,
/area/shuttle/arrival)
"Q" = (
/obj/item/radio/intercom{
	name = "Station Intercom (General)";
	pixel_y = -29
	},
/obj/structure/closet/wardrobe/mixed,
/turf/open/floor/mineral/titanium/tiled/white,
/area/shuttle/arrival)
"R" = (
/turf/open/floor/mineral/titanium/tiled/white,
/area/shuttle/arrival)
"S" = (
/obj/structure/table,
/obj/item/storage/firstaid/regular,
/obj/structure/extinguisher_cabinet{
	pixel_x = -26
	},
/turf/open/floor/mineral/titanium/tiled/white,
/area/shuttle/arrival)
"Z" = (
/obj/structure/closet/wardrobe/green,
/turf/open/floor/mineral/titanium/tiled/white,
/area/shuttle/arrival)

(1,1,1) = {"
a
B
d
d
d
B
a
"}
(2,1,1) = {"
a
b
p
R
v
b
a
"}
(3,1,1) = {"
a
b
q
R
w
b
a
"}
(4,1,1) = {"
b
b
b
t
b
b
b
"}
(5,1,1) = {"
b
e
S
R
I
x
b
"}
(6,1,1) = {"
c
z
z
z
z
z
c
"}
(7,1,1) = {"
b
k
j
z
j
y
b
"}
(8,1,1) = {"
d
j
j
z
j
j
d
"}
(9,1,1) = {"
d
j
j
z
j
j
d
"}
(10,1,1) = {"
d
j
j
z
j
j
d
"}
(11,1,1) = {"
b
k
j
z
j
y
b
"}
(12,1,1) = {"
c
z
z
z
z
z
c
"}
(13,1,1) = {"
b
o
L
Z
H
Q
b
"}
(14,1,1) = {"
b
m
m
m
m
m
b
"}
(15,1,1) = {"
b
n
s
u
s
A
b
"}
