//MAP CONVERTED BY dmm2tgm.py THIS HEADER COMMENT PREVENTS RECONVERSION, DO NOT REMOVE
"aa" = (
/turf/template_noop,
/area/template_noop)
"ab" = (
/turf/closed/wall/mineral/titanium,
/area/shuttle/escape)
"ac" = (
/obj/effect/spawner/structure/window/shuttle,
/turf/open/floor/plating,
/area/shuttle/escape)
"ad" = (
/obj/machinery/recharger{
	pixel_x = -4;
	pixel_y = 4
	},
/obj/structure/table/reinforced,
/obj/item/radio{
	pixel_x = 8;
	pixel_y = 4
	},
/obj/structure/extinguisher_cabinet{
	pixel_x = -28
	},
/turf/open/floor/festive/wooden/wooden1,
/area/shuttle/escape)
"ae" = (
/obj/machinery/computer/emergency_shuttle,
/turf/open/floor/festive/wooden/wooden1,
/area/shuttle/escape)
"af" = (
/obj/machinery/computer/communications,
/turf/open/floor/festive/wooden/wooden1,
/area/shuttle/escape)
"ag" = (
/obj/machinery/computer/atmos_alert{
	dir = 4
	},
/turf/open/floor/festive/wooden/wooden1,
/area/shuttle/escape)
"ah" = (
/obj/structure/chair/comfy/shuttle{
	dir = 1
	},
/turf/open/floor/mineral/titanium/blue,
/area/shuttle/escape)
"ai" = (
/obj/machinery/computer/security{
	dir = 8
	},
/turf/open/floor/festive/wooden/wooden1,
/area/shuttle/escape)
"aj" = (
/obj/machinery/computer/crew{
	dir = 4
	},
/turf/open/floor/festive/wooden/wooden1,
/area/shuttle/escape)
"ak" = (
/obj/machinery/computer/secure_data{
	dir = 8
	},
/turf/open/floor/festive/wooden/wooden1,
/area/shuttle/escape)
"al" = (
/obj/structure/chair/office/dark{
	dir = 8
	},
/turf/open/floor/mineral/titanium/blue,
/area/shuttle/escape)
"am" = (
/obj/machinery/door/airlock/titanium{
	name = "Emergency Shuttle Airlock"
	},
/obj/structure/fans/tiny,
/turf/open/floor/carpet/green,
/area/shuttle/escape)
"an" = (
/obj/machinery/door/airlock/titanium{
	name = "Emergency Shuttle Airlock"
	},
/obj/docking_port/mobile/emergency{
	dir = 8;
	dwidth = 27;
	height = 8;
	name = "PubbyStation emergency shuttle";
	port_direction = 4;
	width = 46
	},
/obj/structure/fans/tiny,
/turf/open/floor/carpet/green,
/area/shuttle/escape)
"aq" = (
/obj/structure/chair/office/dark{
	dir = 4
	},
/turf/open/floor/mineral/titanium/blue,
/area/shuttle/escape)
"ar" = (
/obj/structure/window/reinforced/tinted{
	dir = 8
	},
/turf/open/floor/carpet/green,
/area/shuttle/escape)
"as" = (
/obj/structure/chair/comfy/green,
/turf/open/floor/festive/wooden/wooden1,
/area/shuttle/escape)
"au" = (
/turf/open/floor/plasteel/dark,
/area/shuttle/escape)
"av" = (
/obj/machinery/door/window/eastleft{
	dir = 8;
	name = "Game Room"
	},
/turf/open/floor/festive/wooden/wooden1,
/area/shuttle/escape)
"aw" = (
/obj/structure/table/wood/fancy/green,
/obj/machinery/light/small{
	dir = 4
	},
/obj/item/toy/cards/deck{
	pixel_y = 6
	},
/obj/item/radio/intercom{
	name = "intercom";
	pixel_x = 30;
	pixel_y = -4
	},
/turf/open/floor/festive/wooden/wooden1,
/area/shuttle/escape)
"ax" = (
/turf/open/floor/mineral/plastitanium,
/area/shuttle/escape)
"aB" = (
/obj/structure/window/reinforced/tinted,
/obj/structure/chair/comfy/green{
	dir = 1
	},
/turf/open/floor/festive/wooden/wooden1,
/area/shuttle/escape)
"aF" = (
/obj/structure/closet/emcloset,
/obj/structure/extinguisher_cabinet{
	pixel_x = 24
	},
/turf/open/floor/carpet/green,
/area/shuttle/escape)
"aG" = (
/obj/structure/closet/secure_closet/freezer/fridge,
/obj/structure/window/reinforced{
	dir = 8;
	layer = 2.9
	},
/obj/item/reagent_containers/food/snacks/cakeslice/apple,
/obj/item/reagent_containers/food/snacks/cakeslice/brioche,
/obj/item/reagent_containers/food/snacks/cakeslice/cheese,
/obj/item/reagent_containers/food/snacks/cakeslice/chocolate,
/obj/item/reagent_containers/food/snacks/cakeslice/lemon,
/obj/item/reagent_containers/food/snacks/cakeslice/lime,
/obj/item/reagent_containers/food/snacks/cakeslice/orange,
/turf/open/floor/mineral/titanium/white,
/area/shuttle/escape)
"aH" = (
/turf/open/floor/carpet/green,
/area/shuttle/escape)
"aI" = (
/obj/machinery/door/airlock/public/glass{
	name = "First Class"
	},
/turf/open/floor/carpet/green,
/area/shuttle/escape)
"aJ" = (
/obj/structure/chair/comfy/shuttle,
/turf/open/floor/festive/wooden/wooden1,
/area/shuttle/escape)
"aL" = (
/obj/structure/closet/firecloset,
/obj/structure/extinguisher_cabinet{
	pixel_x = 24
	},
/turf/open/floor/carpet/green,
/area/shuttle/escape)
"aN" = (
/obj/machinery/light/small{
	dir = 8
	},
/turf/open/floor/festive/wooden/wooden1,
/area/shuttle/escape)
"aO" = (
/obj/structure/chair/comfy/shuttle{
	dir = 1
	},
/obj/item/radio/intercom{
	name = "intercom";
	pixel_y = -30
	},
/turf/open/floor/festive/wooden/wooden1,
/area/shuttle/escape)
"aQ" = (
/obj/machinery/light{
	dir = 4
	},
/obj/structure/sign/warning/vacuum/external{
	pixel_x = 32
	},
/turf/open/floor/carpet/green,
/area/shuttle/escape)
"aR" = (
/obj/machinery/light/small{
	dir = 4
	},
/obj/item/radio/intercom{
	name = "intercom";
	pixel_x = 30;
	pixel_y = -4
	},
/turf/open/floor/festive/wooden/wooden1,
/area/shuttle/escape)
"aT" = (
/obj/structure/window/reinforced/tinted{
	dir = 4
	},
/obj/structure/chair/comfy/shuttle,
/turf/open/floor/festive/wooden/wooden1,
/area/shuttle/escape)
"aU" = (
/obj/structure/chair/comfy/shuttle{
	dir = 1
	},
/turf/open/floor/festive/wooden/wooden1,
/area/shuttle/escape)
"aV" = (
/obj/machinery/door/window/eastleft{
	name = "Cabin"
	},
/turf/open/floor/festive/wooden/wooden1,
/area/shuttle/escape)
"aW" = (
/obj/machinery/microwave{
	name = "Michael-Wave";
	pixel_y = 8
	},
/obj/structure/table/glass,
/turf/open/floor/mineral/titanium/white,
/area/shuttle/escape)
"aX" = (
/obj/machinery/sleeper,
/turf/open/floor/mineral/titanium/tiled/blue,
/area/shuttle/escape)
"aY" = (
/obj/structure/window/reinforced/tinted{
	dir = 4
	},
/obj/structure/chair/comfy/shuttle{
	dir = 1
	},
/turf/open/floor/festive/wooden/wooden1,
/area/shuttle/escape)
"aZ" = (
/obj/structure/window/reinforced{
	dir = 4
	},
/obj/structure/table/reinforced,
/obj/item/storage/firstaid/fire{
	pixel_x = -3;
	pixel_y = 3
	},
/obj/item/storage/firstaid{
	pixel_x = 3;
	pixel_y = -3
	},
/turf/open/floor/mineral/titanium/tiled/blue,
/area/shuttle/escape)
"bb" = (
/turf/open/floor/mineral/titanium/tiled/blue,
/area/shuttle/escape)
"bc" = (
/obj/structure/shuttle/engine/propulsion,
/turf/open/floor/plating/airless,
/area/shuttle/escape)
"bd" = (
/turf/open/floor/mineral/titanium/white,
/area/shuttle/escape)
"be" = (
/obj/structure/extinguisher_cabinet{
	pixel_x = -28
	},
/turf/open/floor/mineral/titanium/tiled/blue,
/area/shuttle/escape)
"bf" = (
/obj/structure/sink{
	dir = 4;
	pixel_x = 12
	},
/turf/open/floor/mineral/titanium/white,
/area/shuttle/escape)
"bg" = (
/obj/machinery/portable_atmospherics/scrubber,
/turf/open/floor/mineral/titanium/yellow,
/area/shuttle/escape)
"bh" = (
/obj/machinery/light{
	dir = 8
	},
/turf/open/floor/mineral/titanium/tiled/blue,
/area/shuttle/escape)
"bj" = (
/obj/structure/window/reinforced,
/obj/structure/window/reinforced{
	dir = 8;
	layer = 2.9
	},
/obj/item/reagent_containers/food/snacks/beans{
	pixel_x = 3;
	pixel_y = 4
	},
/obj/structure/table/glass,
/turf/open/floor/mineral/titanium/white,
/area/shuttle/escape)
"bk" = (
/obj/structure/window/reinforced,
/obj/item/storage/bag/tray,
/obj/item/reagent_containers/food/snacks/butterdog,
/obj/structure/table/glass,
/obj/machinery/light{
	dir = 4
	},
/turf/open/floor/mineral/titanium/white,
/area/shuttle/escape)
"bl" = (
/obj/structure/reagent_dispensers/fueltank,
/turf/open/floor/mineral/titanium/yellow,
/area/shuttle/escape)
"bm" = (
/obj/item/radio/intercom{
	name = "intercom";
	pixel_x = 30;
	pixel_y = -4
	},
/obj/structure/chair/comfy/shuttle,
/turf/open/floor/plasteel/dark,
/area/shuttle/escape)
"bn" = (
/obj/machinery/door/window/eastright{
	name = "Storage"
	},
/obj/structure/closet/crate,
/obj/item/storage/toolbox/electrical{
	pixel_y = 2
	},
/obj/item/storage/toolbox/mechanical{
	pixel_y = -2
	},
/turf/open/floor/mineral/titanium/yellow,
/area/shuttle/escape)
"bo" = (
/obj/machinery/porta_turret/centcom_shuttle{
	dir = 9
	},
/turf/closed/wall/mineral/titanium,
/area/shuttle/escape)
"bq" = (
/obj/structure/chair/comfy/shuttle{
	dir = 1
	},
/turf/open/floor/plasteel/dark,
/area/shuttle/escape)
"br" = (
/obj/machinery/light,
/obj/structure/chair/office/dark{
	dir = 8
	},
/turf/open/floor/mineral/titanium/blue,
/area/shuttle/escape)
"bs" = (
/obj/structure/sign/nanotrasen,
/turf/closed/wall/mineral/titanium,
/area/shuttle/escape)
"bt" = (
/obj/machinery/light,
/obj/structure/chair/office/dark{
	dir = 4
	},
/turf/open/floor/mineral/titanium/blue,
/area/shuttle/escape)
"bu" = (
/obj/item/kirbyplants{
	icon_state = "plant-22"
	},
/obj/structure/extinguisher_cabinet{
	pixel_y = 32
	},
/turf/open/floor/mineral/plastitanium,
/area/shuttle/escape)
"bv" = (
/obj/machinery/porta_turret/centcom_shuttle{
	dir = 5
	},
/turf/closed/wall/mineral/titanium,
/area/shuttle/escape)
"bw" = (
/obj/structure/chair/comfy/shuttle{
	dir = 4
	},
/turf/open/floor/mineral/plastitanium,
/area/shuttle/escape)
"bx" = (
/obj/structure/chair/comfy/shuttle{
	dir = 8
	},
/turf/open/floor/mineral/plastitanium,
/area/shuttle/escape)
"by" = (
/obj/structure/table/reinforced,
/obj/machinery/recharger{
	pixel_y = 4
	},
/turf/open/floor/mineral/plastitanium,
/area/shuttle/escape)
"bz" = (
/obj/structure/table/reinforced,
/obj/item/folder/red{
	pixel_y = 4
	},
/obj/item/pen{
	pixel_y = 4
	},
/turf/open/floor/mineral/plastitanium,
/area/shuttle/escape)
"bA" = (
/obj/machinery/door/airlock/public/glass{
	name = "Cell 2";
	req_access_txt = "2"
	},
/turf/open/floor/mineral/plastitanium,
/area/shuttle/escape)
"bB" = (
/obj/structure/window/reinforced/tinted{
	dir = 4
	},
/obj/machinery/flasher{
	id = "cockpit_flasher2";
	pixel_y = 24
	},
/turf/open/floor/plasteel,
/area/shuttle/escape)
"bC" = (
/obj/structure/window/reinforced/tinted{
	dir = 8
	},
/obj/machinery/flasher{
	id = "cockpit_flasher1";
	pixel_y = 24
	},
/turf/open/floor/plasteel,
/area/shuttle/escape)
"bD" = (
/obj/structure/bed{
	dir = 1
	},
/obj/item/bedsheet/orange{
	dir = 8
	},
/turf/open/floor/plasteel,
/area/shuttle/escape)
"bE" = (
/obj/structure/shuttle/engine/heater,
/obj/effect/spawner/structure/window/shuttle,
/turf/open/floor/plating,
/area/shuttle/escape)
"bG" = (
/obj/structure/chair/comfy/shuttle{
	dir = 1
	},
/obj/structure/window/reinforced{
	dir = 8
	},
/turf/open/floor/plasteel/dark,
/area/shuttle/escape)
"bH" = (
/obj/machinery/light{
	dir = 1
	},
/turf/open/floor/mineral/plastitanium,
/area/shuttle/escape)
"bI" = (
/obj/machinery/light,
/turf/open/floor/plasteel,
/area/shuttle/escape)
"bK" = (
/obj/machinery/door/airlock/public/glass{
	name = "Economy Class"
	},
/turf/open/floor/carpet/green,
/area/shuttle/escape)
"bO" = (
/obj/machinery/door/airlock/public/glass{
	name = "Cockpit";
	req_access_txt = "19"
	},
/turf/open/floor/carpet/green,
/area/shuttle/escape)
"bQ" = (
/obj/machinery/door/airlock/public/glass{
	name = "Service"
	},
/turf/open/floor/plasteel/dark,
/area/shuttle/escape)
"bT" = (
/obj/machinery/door/airlock/public/glass{
	name = "Brig";
	req_access_txt = "2"
	},
/turf/open/floor/plasteel/dark,
/area/shuttle/escape)
"dK" = (
/obj/structure/table/reinforced,
/obj/item/storage/fancy/donut_box{
	pixel_y = 2
	},
/turf/open/floor/mineral/plastitanium,
/area/shuttle/escape)
"eG" = (
/obj/machinery/door/airlock/public/glass{
	name = "Cell 1";
	req_access_txt = "2"
	},
/turf/open/floor/mineral/plastitanium,
/area/shuttle/escape)
"js" = (
/obj/structure/window/reinforced/tinted{
	dir = 4
	},
/obj/structure/chair/comfy/shuttle,
/obj/item/radio/intercom{
	name = "intercom";
	pixel_y = 24
	},
/turf/open/floor/festive/wooden/wooden1,
/area/shuttle/escape)
"lz" = (
/obj/structure/window/reinforced/tinted{
	dir = 8
	},
/obj/structure/chair/comfy/shuttle{
	dir = 1
	},
/turf/open/floor/festive/wooden/wooden1,
/area/shuttle/escape)
"lX" = (
/obj/structure/window/reinforced{
	dir = 4
	},
/turf/open/floor/mineral/titanium/tiled/blue,
/area/shuttle/escape)
"mK" = (
/obj/machinery/button/flasher{
	id = "cockpit_flasher2";
	pixel_y = -24
	},
/obj/structure/chair/comfy/shuttle{
	dir = 1
	},
/turf/open/floor/mineral/plastitanium,
/area/shuttle/escape)
"nM" = (
/obj/machinery/porta_turret/centcom_shuttle{
	dir = 6
	},
/turf/closed/wall/mineral/titanium,
/area/shuttle/escape)
"nO" = (
/obj/machinery/button/flasher{
	id = "cockpit_flasher1";
	pixel_y = -24
	},
/obj/structure/chair/comfy/shuttle{
	dir = 1
	},
/turf/open/floor/mineral/plastitanium,
/area/shuttle/escape)
"pp" = (
/obj/structure/window/reinforced/tinted{
	dir = 8
	},
/obj/structure/toilet{
	dir = 4;
	pixel_x = 8
	},
/turf/open/floor/plasteel,
/area/shuttle/escape)
"qU" = (
/obj/structure/window/reinforced/tinted{
	dir = 1
	},
/turf/open/floor/carpet/green,
/area/shuttle/escape)
"rY" = (
/turf/open/floor/festive/wooden/wooden1,
/area/shuttle/escape)
"sI" = (
/obj/item/storage/backpack/duffelbag/med/surgery,
/obj/structure/table,
/obj/structure/window/reinforced/tinted,
/obj/structure/window/reinforced{
	dir = 4
	},
/turf/open/floor/mineral/titanium/tiled/blue,
/area/shuttle/escape)
"tz" = (
/obj/structure/closet/emcloset,
/turf/open/floor/carpet/green,
/area/shuttle/escape)
"ub" = (
/obj/structure/table/reinforced,
/obj/item/melee/baton,
/obj/item/restraints/handcuffs,
/turf/open/floor/mineral/plastitanium,
/area/shuttle/escape)
"uG" = (
/turf/open/floor/plasteel,
/area/shuttle/escape)
"vt" = (
/obj/structure/window/reinforced/tinted{
	dir = 4
	},
/turf/open/floor/carpet/green,
/area/shuttle/escape)
"xt" = (
/obj/structure/window/plasma/reinforced{
	dir = 8
	},
/turf/open/floor/carpet/green,
/area/shuttle/escape)
"xw" = (
/obj/machinery/cell_charger,
/obj/structure/table/reinforced,
/obj/item/crowbar{
	pixel_y = 2
	},
/obj/item/radio/intercom{
	name = "intercom";
	pixel_x = 30;
	pixel_y = -4
	},
/turf/open/floor/festive/wooden/wooden1,
/area/shuttle/escape)
"Ca" = (
/obj/structure/sink{
	pixel_y = 28
	},
/turf/open/floor/plasteel,
/area/shuttle/escape)
"Ct" = (
/obj/machinery/porta_turret/centcom_shuttle{
	dir = 10
	},
/turf/closed/wall/mineral/titanium,
/area/shuttle/escape)
"Cw" = (
/obj/structure/closet/firecloset,
/turf/open/floor/carpet/green,
/area/shuttle/escape)
"Dx" = (
/obj/structure/window/reinforced/tinted{
	dir = 8
	},
/obj/structure/window/reinforced/tinted,
/turf/open/floor/festive/wooden/wooden1,
/area/shuttle/escape)
"ET" = (
/obj/item/kirbyplants{
	icon_state = "plant-22"
	},
/obj/item/radio/intercom{
	name = "intercom";
	pixel_y = 24
	},
/turf/open/floor/mineral/plastitanium,
/area/shuttle/escape)
"FS" = (
/obj/structure/window/reinforced/tinted,
/turf/open/floor/carpet/green,
/area/shuttle/escape)
"FX" = (
/obj/structure/window/plasma/reinforced{
	dir = 8
	},
/turf/open/floor/plasteel/dark,
/area/shuttle/escape)
"Jw" = (
/obj/structure/table/optable,
/obj/structure/window/reinforced/tinted,
/turf/open/floor/mineral/titanium/tiled/blue,
/area/shuttle/escape)
"Kh" = (
/obj/structure/window/reinforced/tinted{
	dir = 4
	},
/obj/structure/toilet{
	dir = 8;
	pixel_x = -8
	},
/turf/open/floor/plasteel,
/area/shuttle/escape)
"NX" = (
/turf/closed/wall/mineral/titanium/nodiagonal,
/area/shuttle/escape)
"Ov" = (
/obj/structure/window/reinforced/tinted{
	dir = 1
	},
/obj/structure/window/reinforced/tinted{
	dir = 8
	},
/obj/structure/chair/comfy/shuttle,
/turf/open/floor/festive/wooden/wooden1,
/area/shuttle/escape)
"Pq" = (
/obj/machinery/door/airlock/public/glass{
	name = "Economy Class"
	},
/turf/open/floor/plasteel/dark,
/area/shuttle/escape)
"Qh" = (
/obj/structure/window/reinforced/tinted{
	dir = 1
	},
/obj/structure/chair/comfy/shuttle,
/turf/open/floor/festive/wooden/wooden1,
/area/shuttle/escape)
"Tb" = (
/obj/structure/window/reinforced/tinted{
	dir = 8
	},
/turf/open/floor/festive/wooden/wooden1,
/area/shuttle/escape)
"Tv" = (
/obj/structure/chair/comfy/shuttle,
/obj/structure/window/reinforced{
	dir = 8
	},
/turf/open/floor/plasteel/dark,
/area/shuttle/escape)
"Uu" = (
/obj/structure/window/plasma/reinforced{
	dir = 4
	},
/turf/open/floor/carpet/green,
/area/shuttle/escape)
"WC" = (
/obj/structure/bed,
/obj/item/bedsheet/orange,
/turf/open/floor/plasteel,
/area/shuttle/escape)
"Xc" = (
/obj/machinery/door/window/eastleft{
	name = "Storage"
	},
/obj/machinery/portable_atmospherics/pump,
/turf/open/floor/mineral/titanium/yellow,
/area/shuttle/escape)
"YF" = (
/obj/structure/window/plasma/reinforced{
	dir = 4
	},
/turf/open/floor/plasteel/dark,
/area/shuttle/escape)

(1,1,1) = {"
aa
ab
ac
ac
ab
aa
ab
ac
ab
ac
ab
ac
ab
ac
ab
aa
ab
ac
ab
ac
ab
ac
ab
ac
ab
aa
ab
ab
ac
ab
ab
ab
ac
ab
ab
aa
ab
ab
ac
ac
ab
bs
ab
ab
ab
Ct
"}
(2,1,1) = {"
bo
NX
ag
aj
ab
aa
ab
aJ
aN
aO
ab
aJ
aN
aU
ab
aa
ab
aJ
aN
aO
ab
aJ
aN
aU
ab
aa
ab
aX
bb
be
bh
Jw
bg
bl
ab
aa
ab
bu
bw
bw
dK
ab
Ca
bD
bE
bc
"}
(3,1,1) = {"
ac
ad
al
br
ab
aa
bs
aT
aV
aY
ab
js
aV
aY
bs
aa
bs
aT
aV
aY
ab
js
aV
aY
bs
aa
bs
aZ
lX
bb
lX
sI
Xc
bn
bs
aa
bs
bH
ax
ax
ax
bA
uG
bI
bE
bc
"}
(4,1,1) = {"
ac
ae
ah
aH
bO
xt
aI
ar
aH
ar
ar
ar
aH
ar
aI
xt
bK
ar
aH
ar
ar
ar
aH
ar
Pq
FX
bQ
au
au
au
au
au
au
au
bQ
FX
bT
ax
ax
by
mK
ab
bB
Kh
bE
bc
"}
(5,1,1) = {"
ac
af
ah
aH
bO
Uu
aI
vt
aH
vt
aH
aH
aH
aH
aI
Uu
bK
aH
aH
aH
aH
vt
aH
vt
Pq
YF
bQ
au
au
au
au
au
au
au
bQ
YF
bT
ax
ax
bz
nO
ab
bC
pp
bE
bc
"}
(6,1,1) = {"
ac
xw
aq
bt
ab
aa
bs
Tb
av
Dx
qU
aH
aH
Cw
bs
aa
bs
tz
aH
aH
FS
Ov
rY
lz
bs
aa
bs
aG
bd
bd
bj
Tv
au
bG
bs
aa
bs
bH
ax
ax
ax
eG
uG
bI
bE
bc
"}
(7,1,1) = {"
bv
NX
ai
ak
ab
aa
ab
as
aw
aB
qU
aQ
aH
aF
ab
aa
ab
aL
aH
aQ
FS
Qh
aR
aU
ab
aa
ab
aW
bd
bf
bk
bm
au
bq
ab
aa
ab
ET
bx
bx
ub
ab
Ca
WC
bE
bc
"}
(8,1,1) = {"
aa
ab
ac
ac
ab
aa
ab
ab
ab
ab
am
ab
am
ab
ab
aa
ab
ab
an
ab
am
ac
ab
ac
ab
aa
ab
ab
ac
ab
ab
ab
ac
ab
ab
aa
ab
ab
ac
ac
ab
bs
ab
ab
ab
nM
"}
