//MAP CONVERTED BY dmm2tgm.py THIS HEADER COMMENT PREVENTS RECONVERSION, DO NOT REMOVE
"aa" = (
/turf/template_noop,
/area/template_noop)
"ab" = (
/obj/machinery/door/airlock/titanium{
	name = "Emergency Shuttle Airlock";
	req_access_txt = "2"
	},
/obj/structure/fans/tiny,
/turf/open/floor/mineral/plastitanium/red/brig,
/area/shuttle/escape)
"ac" = (
/obj/effect/spawner/structure/window/shuttle,
/turf/open/floor/plating,
/area/shuttle/escape)
"ad" = (
/turf/closed/wall/mineral/titanium,
/area/shuttle/escape)
"ae" = (
/turf/closed/wall/mineral/titanium/interior,
/area/shuttle/escape)
"af" = (
/obj/machinery/recharger{
	pixel_x = -6;
	pixel_y = 4
	},
/obj/structure/extinguisher_cabinet{
	pixel_x = -26
	},
/obj/item/radio{
	pixel_x = 6;
	pixel_y = 6
	},
/obj/item/crowbar/red{
	pixel_x = 2
	},
/obj/structure/table/reinforced,
/turf/open/floor/mineral/titanium/blue,
/area/shuttle/escape)
"ag" = (
/obj/structure/chair/comfy/shuttle{
	dir = 1
	},
/turf/open/floor/mineral/titanium/blue,
/area/shuttle/escape)
"ah" = (
/obj/machinery/computer/emergency_shuttle,
/turf/open/floor/mineral/titanium/blue,
/area/shuttle/escape)
"ai" = (
/obj/item/storage/firstaid/regular{
	pixel_y = 4
	},
/obj/item/radio/intercom{
	name = "Station Intercom (General)";
	pixel_x = 32;
	pixel_y = -4
	},
/obj/structure/table/reinforced,
/turf/open/floor/mineral/titanium/blue,
/area/shuttle/escape)
"aj" = (
/obj/machinery/door/airlock/titanium{
	name = "Emergency Shuttle Airlock"
	},
/obj/docking_port/mobile/emergency{
	name = "Box emergency shuttle"
	},
/obj/structure/fans/tiny,
/turf/open/floor/mineral/titanium/tiled,
/area/shuttle/escape)
"ak" = (
/obj/machinery/door/airlock/titanium{
	name = "Emergency Shuttle Airlock"
	},
/obj/structure/fans/tiny,
/turf/open/floor/mineral/titanium/tiled,
/area/shuttle/escape)
"al" = (
/obj/machinery/computer/atmos_alert{
	dir = 4
	},
/turf/open/floor/mineral/titanium/blue,
/area/shuttle/escape)
"am" = (
/obj/structure/chair/comfy/shuttle{
	dir = 8
	},
/turf/open/floor/mineral/titanium/blue,
/area/shuttle/escape)
"an" = (
/turf/open/floor/mineral/titanium/blue,
/area/shuttle/escape)
"ao" = (
/obj/structure/chair/comfy/shuttle{
	dir = 4
	},
/turf/open/floor/mineral/titanium/blue,
/area/shuttle/escape)
"ap" = (
/obj/machinery/computer/security{
	dir = 8
	},
/turf/open/floor/mineral/titanium/blue,
/area/shuttle/escape)
"aq" = (
/obj/machinery/computer/crew{
	dir = 4
	},
/turf/open/floor/mineral/titanium/blue,
/area/shuttle/escape)
"ar" = (
/obj/structure/chair/comfy/shuttle{
	dir = 4
	},
/obj/machinery/button/flasher{
	id = "cockpit_flasher";
	pixel_y = -24
	},
/turf/open/floor/mineral/titanium/blue,
/area/shuttle/escape)
"au" = (
/obj/machinery/computer/communications{
	dir = 8
	},
/turf/open/floor/mineral/titanium/blue,
/area/shuttle/escape)
"ay" = (
/obj/machinery/door/airlock/public/glass{
	name = "Emergency Shuttle Cockpit";
	req_access_txt = "19"
	},
/turf/open/floor/mineral/titanium/tiled,
/area/shuttle/escape)
"az" = (
/obj/machinery/status_display/evac,
/turf/closed/wall/mineral/titanium,
/area/shuttle/escape)
"aA" = (
/obj/structure/chair/comfy/shuttle,
/turf/open/floor/mineral/plastitanium/red/brig,
/area/shuttle/escape)
"aB" = (
/obj/machinery/light{
	dir = 1
	},
/turf/open/floor/mineral/titanium/blue,
/area/shuttle/escape)
"aC" = (
/turf/open/floor/mineral/titanium/tiled,
/area/shuttle/escape)
"aD" = (
/obj/structure/closet/firecloset,
/turf/open/floor/mineral/titanium/blue,
/area/shuttle/escape)
"aE" = (
/obj/structure/closet/emcloset,
/turf/open/floor/mineral/titanium/blue,
/area/shuttle/escape)
"aF" = (
/obj/machinery/light/small{
	brightness = 3;
	dir = 8
	},
/obj/structure/sign/warning/vacuum{
	pixel_x = -32
	},
/turf/open/floor/mineral/plastitanium/red/brig,
/area/shuttle/escape)
"aG" = (
/turf/open/floor/mineral/plastitanium/red/brig,
/area/shuttle/escape)
"aH" = (
/obj/machinery/door/airlock/public/glass{
	name = "Emergency Shuttle Brig";
	req_access_txt = "2"
	},
/turf/open/floor/mineral/plastitanium/red/brig,
/area/shuttle/escape)
"aJ" = (
/obj/structure/chair/comfy/shuttle{
	dir = 1
	},
/turf/open/floor/mineral/plastitanium/red/brig,
/area/shuttle/escape)
"aK" = (
/obj/structure/chair/comfy/shuttle,
/turf/open/floor/mineral/titanium/blue,
/area/shuttle/escape)
"aM" = (
/obj/structure/table,
/turf/open/floor/mineral/titanium/blue,
/area/shuttle/escape)
"aQ" = (
/obj/structure/extinguisher_cabinet{
	pixel_y = 30
	},
/turf/open/floor/mineral/titanium/tiled,
/area/shuttle/escape)
"aR" = (
/obj/structure/extinguisher_cabinet{
	pixel_x = 27
	},
/obj/machinery/light/small{
	dir = 4
	},
/turf/open/floor/mineral/titanium/tiled,
/area/shuttle/escape)
"aS" = (
/obj/structure/chair/comfy/shuttle{
	dir = 8
	},
/obj/structure/window/reinforced{
	dir = 4
	},
/turf/open/floor/mineral/titanium/blue,
/area/shuttle/escape)
"aT" = (
/obj/structure/chair/comfy/shuttle{
	dir = 4
	},
/obj/structure/window/reinforced{
	dir = 8
	},
/turf/open/floor/mineral/titanium/blue,
/area/shuttle/escape)
"aW" = (
/obj/structure/extinguisher_cabinet{
	pixel_y = -30
	},
/turf/open/floor/mineral/titanium/tiled,
/area/shuttle/escape)
"aX" = (
/obj/machinery/door/airlock/titanium{
	name = "Emergency Shuttle Cargo"
	},
/turf/open/floor/mineral/titanium/yellow,
/area/shuttle/escape)
"aZ" = (
/obj/machinery/door/airlock/public/glass{
	name = "Emergency Shuttle Infirmary"
	},
/turf/open/floor/mineral/titanium/white,
/area/shuttle/escape)
"bb" = (
/turf/open/floor/mineral/titanium/yellow,
/area/shuttle/escape)
"bc" = (
/obj/structure/closet,
/turf/open/floor/mineral/titanium/yellow,
/area/shuttle/escape)
"bd" = (
/obj/structure/table,
/obj/item/storage/firstaid/regular{
	pixel_x = 3;
	pixel_y = 3
	},
/obj/item/storage/firstaid/fire{
	pixel_x = -3;
	pixel_y = -3
	},
/obj/item/crowbar,
/turf/open/floor/mineral/titanium/white,
/area/shuttle/escape)
"be" = (
/obj/machinery/light/small{
	dir = 4
	},
/obj/structure/extinguisher_cabinet{
	pixel_x = 26
	},
/obj/structure/table/optable,
/turf/open/floor/mineral/titanium/white,
/area/shuttle/escape)
"bf" = (
/obj/structure/closet/crate/internals,
/turf/open/floor/mineral/titanium/yellow,
/area/shuttle/escape)
"bg" = (
/obj/item/chair{
	pixel_x = 2;
	pixel_y = -6
	},
/turf/open/floor/mineral/titanium/yellow,
/area/shuttle/escape)
"bi" = (
/obj/structure/window/reinforced{
	dir = 1
	},
/obj/structure/shuttle/engine/heater,
/turf/open/floor/plating/airless,
/area/shuttle/escape)
"bj" = (
/turf/closed/wall/mineral/titanium/nodiagonal,
/area/shuttle/escape)
"bk" = (
/obj/structure/shuttle/engine/propulsion,
/turf/open/floor/plating/airless,
/area/shuttle/escape)
"bl" = (
/obj/machinery/light/small{
	dir = 4
	},
/turf/open/floor/mineral/titanium/blue,
/area/shuttle/escape)
"bm" = (
/obj/structure/table,
/obj/machinery/light{
	dir = 8
	},
/turf/open/floor/mineral/titanium/blue,
/area/shuttle/escape)
"bn" = (
/obj/machinery/light/small{
	dir = 1
	},
/turf/open/floor/mineral/titanium/tiled,
/area/shuttle/escape)
"bo" = (
/obj/machinery/light/small,
/turf/open/floor/mineral/titanium/tiled,
/area/shuttle/escape)
"bp" = (
/obj/machinery/light,
/turf/open/floor/mineral/titanium/tiled,
/area/shuttle/escape)
"bq" = (
/obj/machinery/light/small{
	brightness = 3;
	dir = 8
	},
/obj/structure/sign/warning/vacuum{
	pixel_x = -32
	},
/turf/open/floor/mineral/titanium/yellow,
/area/shuttle/escape)
"br" = (
/obj/machinery/light/small{
	dir = 4
	},
/obj/structure/extinguisher_cabinet{
	pixel_x = 26
	},
/obj/structure/closet,
/turf/open/floor/mineral/titanium/yellow,
/area/shuttle/escape)
"bs" = (
/obj/machinery/light/small{
	brightness = 3;
	dir = 8
	},
/obj/structure/closet/emcloset,
/turf/open/floor/mineral/titanium/white,
/area/shuttle/escape)
"eA" = (
/obj/structure/table,
/obj/machinery/cell_charger,
/turf/open/floor/mineral/titanium/blue,
/area/shuttle/escape)
"ga" = (
/turf/open/floor/mineral/titanium/white,
/area/shuttle/escape)
"iL" = (
/obj/machinery/door/airlock/titanium{
	name = "Emergency Shuttle Airlock"
	},
/obj/structure/fans/tiny,
/turf/open/floor/mineral/titanium/yellow,
/area/shuttle/escape)
"uh" = (
/obj/structure/closet/crate,
/obj/item/stack/sheet/mineral/wood/twenty,
/turf/open/floor/mineral/titanium/yellow,
/area/shuttle/escape)
"BG" = (
/obj/structure/table,
/obj/item/reagent_containers/food/snacks/mint,
/obj/item/reagent_containers/food/snacks/mint{
	pixel_y = 3
	},
/obj/item/reagent_containers/food/snacks/mint{
	pixel_y = 6
	},
/turf/open/floor/mineral/titanium/blue,
/area/shuttle/escape)
"CS" = (
/obj/structure/table,
/obj/item/storage/backpack/duffelbag/med/surgery,
/turf/open/floor/mineral/titanium/white,
/area/shuttle/escape)
"ON" = (
/obj/machinery/light/small{
	dir = 4
	},
/turf/open/floor/mineral/titanium/tiled,
/area/shuttle/escape)
"OW" = (
/obj/structure/chair/comfy/shuttle{
	dir = 4
	},
/obj/structure/sign/warning/vacuum{
	pixel_x = -32
	},
/turf/open/floor/mineral/titanium/blue,
/area/shuttle/escape)
"XC" = (
/obj/machinery/sleeper{
	dir = 4
	},
/turf/open/floor/mineral/titanium/white,
/area/shuttle/escape)
"YI" = (
/obj/machinery/flasher{
	id = "cockpit_flasher";
	pixel_y = 24
	},
/turf/open/floor/mineral/titanium/blue,
/area/shuttle/escape)
"ZQ" = (
/obj/structure/chair/comfy/shuttle,
/obj/machinery/flasher{
	id = "shuttle_flasher";
	pixel_x = -6;
	pixel_y = 24
	},
/obj/machinery/button/flasher{
	id = "shuttle_flasher";
	pixel_x = 6;
	pixel_y = 24
	},
/turf/open/floor/mineral/plastitanium/red/brig,
/area/shuttle/escape)

(1,1,1) = {"
aa
aa
aa
aa
ad
ad
ad
ab
ad
aj
ad
ac
ac
ac
ad
ak
ad
iL
ad
ad
ad
aa
"}
(2,1,1) = {"
aa
ad
ad
ad
ad
aA
aF
aG
ad
bn
OW
ao
ao
ao
OW
bo
ad
bb
bq
bf
ad
ad
"}
(3,1,1) = {"
ad
ae
al
aq
ad
ZQ
aG
aJ
ad
aQ
aC
aC
aC
aC
aC
aW
ad
bb
bb
uh
bi
bk
"}
(4,1,1) = {"
ac
af
am
am
ad
aA
aG
aJ
ad
aC
aS
aS
aS
aS
aS
aC
aX
bb
bb
bb
bi
bk
"}
(5,1,1) = {"
ac
ag
aC
aC
ad
ac
aH
ac
bj
aC
aT
aT
aT
aT
aT
aC
ad
bc
br
bg
bi
bk
"}
(6,1,1) = {"
ac
ah
aC
bp
az
aB
aC
aK
bm
aC
aC
aC
aC
aC
aC
bp
az
ad
ad
ad
bi
bk
"}
(7,1,1) = {"
ac
ag
aC
aC
ay
aC
aC
ao
BG
aC
aS
aS
aS
aS
aS
aC
ac
XC
bs
XC
bi
bk
"}
(8,1,1) = {"
ac
ai
ao
ar
ad
YI
aC
eA
aM
aC
aT
aT
aT
aT
aT
aC
aZ
ga
ga
ga
bi
bk
"}
(9,1,1) = {"
ad
ae
ap
au
ad
aD
aC
aC
aC
aC
aC
aC
aC
aC
aC
aC
ac
ga
ga
ga
bi
bk
"}
(10,1,1) = {"
aa
ad
ad
ad
ad
aE
bl
an
an
aR
am
am
am
am
am
ON
ac
bd
be
CS
ad
ad
"}
(11,1,1) = {"
aa
aa
aa
aa
ad
ac
ad
ac
ad
ad
ad
ac
ac
ac
ad
ad
ad
ac
ad
ac
ad
aa
"}
