//MAP CONVERTED BY dmm2tgm.py THIS HEADER COMMENT PREVENTS RECONVERSION, DO NOT REMOVE
"a" = (
/turf/closed/wall/mineral/titanium,
/area/shuttle/mining)
"b" = (
/obj/effect/spawner/structure/window/shuttle,
/turf/open/floor/plating,
/area/shuttle/mining)
"c" = (
/obj/structure/table,
/obj/item/storage/toolbox/emergency,
/turf/open/floor/mineral/plastitanium,
/area/shuttle/mining)
"d" = (
/obj/machinery/computer/shuttle/mining/common,
/obj/effect/turf_decal/bot,
/turf/open/floor/mineral/plastitanium,
/area/shuttle/mining)
"e" = (
/obj/structure/table,
/obj/item/radio,
/obj/item/radio/intercom{
	pixel_x = 32;
	pixel_y = -4
	},
/turf/open/floor/mineral/plastitanium,
/area/shuttle/mining)
"f" = (
/obj/effect/turf_decal/stripes/line{
	dir = 9
	},
/turf/open/floor/mineral/titanium/yellow,
/area/shuttle/mining)
"g" = (
/obj/structure/chair/comfy/shuttle{
	dir = 1
	},
/obj/effect/turf_decal/stripes/line{
	dir = 1
	},
/obj/effect/turf_decal/stripes/corner{
	dir = 8
	},
/turf/open/floor/mineral/titanium/yellow,
/area/shuttle/mining)
"h" = (
/obj/effect/turf_decal/stripes/line{
	dir = 5
	},
/turf/open/floor/mineral/titanium/yellow,
/area/shuttle/mining)
"i" = (
/obj/structure/sign/nanotrasen,
/turf/closed/wall/mineral/titanium,
/area/shuttle/mining)
"j" = (
/obj/machinery/light{
	dir = 8
	},
/obj/effect/turf_decal/stripes/line{
	dir = 10
	},
/turf/open/floor/mineral/titanium/yellow,
/area/shuttle/mining)
"k" = (
/obj/effect/turf_decal/stripes/line,
/obj/machinery/atmospherics/components/unary/vent_pump/on{
	dir = 4
	},
/turf/open/floor/mineral/titanium/yellow,
/area/shuttle/mining)
"l" = (
/obj/effect/turf_decal/stripes/line,
/obj/effect/turf_decal/stripes/corner{
	dir = 8
	},
/obj/machinery/atmospherics/pipe/simple/general/hidden{
	dir = 8
	},
/turf/open/floor/mineral/titanium/yellow,
/area/shuttle/mining)
"m" = (
/obj/machinery/door/airlock/titanium{
	name = "Lavaland Shuttle Airlock"
	},
/obj/docking_port/mobile{
	dir = 8;
	dwidth = 3;
	height = 5;
	id = "mining_shuttle_common";
	name = "lavaland shuttle";
	port_direction = 4;
	width = 7
	},
/obj/machinery/atmospherics/pipe/simple/general/hidden{
	dir = 8
	},
/obj/effect/turf_decal/stripes/line{
	dir = 8
	},
/obj/effect/turf_decal/stripes/line{
	dir = 4
	},
/turf/open/floor/mineral/titanium/yellow,
/area/shuttle/mining)
"n" = (
/obj/structure/chair/comfy/shuttle{
	dir = 1
	},
/obj/effect/turf_decal/bot,
/turf/open/floor/mineral/plastitanium,
/area/shuttle/mining)
"o" = (
/obj/item/clothing/suit/hazardvest{
	desc = "A high-visibility lifejacket complete with whistle and slot for oxygen tanks.";
	name = "emergency lifejacket"
	},
/obj/item/clothing/suit/hazardvest{
	desc = "A high-visibility lifejacket complete with whistle and slot for oxygen tanks.";
	name = "emergency lifejacket"
	},
/obj/item/tank/internals/emergency_oxygen{
	pixel_x = 3
	},
/obj/item/tank/internals/emergency_oxygen{
	pixel_x = 3
	},
/obj/item/clothing/mask/breath{
	pixel_x = -3;
	pixel_y = -3
	},
/obj/item/clothing/mask/breath{
	pixel_x = -3;
	pixel_y = -3
	},
/obj/item/clothing/head/hardhat/orange{
	name = "protective hat";
	pixel_y = 9
	},
/obj/item/clothing/head/hardhat/orange{
	name = "protective hat";
	pixel_y = 9
	},
/obj/structure/closet/crate/internals,
/obj/machinery/airalarm{
	dir = 4;
	pixel_x = -22
	},
/obj/machinery/light/small,
/obj/effect/turf_decal/box,
/turf/open/floor/mineral/plastitanium,
/area/shuttle/mining)
"p" = (
/obj/effect/spawner/structure/window/shuttle,
/obj/structure/shuttle/engine/heater,
/turf/open/floor/plating,
/area/shuttle/mining)
"q" = (
/obj/structure/ore_box,
/obj/effect/turf_decal/delivery,
/turf/open/floor/mineral/plastitanium,
/area/shuttle/mining)
"r" = (
/obj/structure/sign/mining,
/turf/closed/wall/mineral/titanium,
/area/shuttle/mining)
"s" = (
/obj/structure/shuttle/engine/propulsion/burst,
/turf/open/floor/plating/airless,
/area/shuttle/mining)

(1,1,1) = {"
a
a
b
i
b
a
a
"}
(2,1,1) = {"
i
c
f
j
n
o
r
"}
(3,1,1) = {"
b
d
g
k
n
p
s
"}
(4,1,1) = {"
r
e
h
l
n
q
i
"}
(5,1,1) = {"
a
a
b
m
b
a
a
"}
