//MAP CONVERTED BY dmm2tgm.py THIS HEADER COMMENT PREVENTS RECONVERSION, DO NOT REMOVE
"a" = (
/turf/closed/wall/mineral/titanium,
/area/shuttle/mining)
"b" = (
/obj/effect/spawner/structure/window/shuttle,
/turf/open/floor/plating,
/area/shuttle/mining)
"c" = (
/obj/structure/table,
/obj/item/storage/toolbox/emergency{
	pixel_y = 2
	},
/obj/item/clothing/mask/gas/explorer{
	pixel_x = -4;
	pixel_y = 6
	},
/turf/open/floor/mineral/titanium,
/area/shuttle/mining)
"d" = (
/obj/machinery/computer/shuttle/mining,
/turf/open/floor/mineral/titanium,
/area/shuttle/mining)
"e" = (
/turf/open/floor/mineral/titanium,
/area/shuttle/mining)
"g" = (
/obj/machinery/light{
	dir = 8
	},
/obj/structure/sign/departments/cargo{
	pixel_x = -32
	},
/turf/open/floor/mineral/titanium,
/area/shuttle/mining)
"h" = (
/obj/machinery/door/airlock/titanium{
	name = "Mining Shuttle Airlock"
	},
/obj/docking_port/mobile{
	dir = 8;
	dwidth = 3;
	height = 5;
	id = "mining";
	name = "mining shuttle";
	port_direction = 4;
	width = 7
	},
/turf/open/floor/mineral/titanium,
/area/shuttle/mining)
"i" = (
/obj/structure/closet/crate/internals,
/obj/item/clothing/suit/hazardvest,
/obj/item/clothing/suit/hazardvest,
/obj/item/clothing/suit/hazardvest,
/obj/item/tank/internals/emergency_oxygen/double{
	pixel_x = 3;
	pixel_y = -3
	},
/obj/item/tank/internals/emergency_oxygen/double{
	pixel_x = 3;
	pixel_y = -3
	},
/obj/item/tank/internals/emergency_oxygen/double{
	pixel_x = 3;
	pixel_y = -3
	},
/obj/item/clothing/mask/breath{
	pixel_x = -4;
	pixel_y = 4
	},
/obj/item/clothing/mask/breath{
	pixel_x = -4;
	pixel_y = 4
	},
/obj/item/clothing/mask/breath{
	pixel_x = -4;
	pixel_y = 4
	},
/turf/open/floor/mineral/titanium,
/area/shuttle/mining)
"j" = (
/obj/structure/shuttle/engine/heater,
/obj/structure/window/reinforced{
	dir = 1;
	layer = 2.9
	},
/obj/structure/window/reinforced{
	dir = 8
	},
/obj/structure/window/reinforced{
	dir = 4
	},
/turf/open/floor/plating,
/area/shuttle/mining)
"k" = (
/obj/structure/ore_box,
/turf/open/floor/mineral/titanium,
/area/shuttle/mining)
"l" = (
/obj/structure/shuttle/engine/propulsion/burst,
/turf/open/floor/plating/airless,
/area/shuttle/mining)
"x" = (
/obj/structure/sign/nanotrasen,
/turf/closed/wall/mineral/titanium,
/area/shuttle/mining)
"B" = (
/obj/structure/sign/mining,
/turf/closed/wall/mineral/titanium,
/area/shuttle/mining)
"C" = (
/obj/structure/table,
/obj/item/radio/intercom{
	name = "Station Intercom (General)";
	pixel_x = 32;
	pixel_y = -4
	},
/obj/item/flashlight/flare{
	pixel_y = 4
	},
/obj/item/flashlight/flare{
	pixel_y = 10
	},
/obj/item/flashlight/flare{
	pixel_y = -2
	},
/turf/open/floor/mineral/titanium,
/area/shuttle/mining)
"Q" = (
/obj/structure/chair/comfy/shuttle{
	dir = 1
	},
/turf/open/floor/mineral/titanium,
/area/shuttle/mining)

(1,1,1) = {"
a
a
b
a
b
a
a
"}
(2,1,1) = {"
x
c
e
g
Q
i
B
"}
(3,1,1) = {"
b
d
Q
e
Q
j
l
"}
(4,1,1) = {"
B
C
e
e
Q
k
x
"}
(5,1,1) = {"
a
a
b
h
b
a
a
"}
